1111111111
1000100001
1000100001
1101100001
1N000000011111
11111011100001
	1000111101
	1000000001
	1000000001
	1111111111
