NO ./srcs/sprites/test/WallN.xpm
SO ./srcs/sprites/test/WallS.xpm
WE ./srcs/sprites/test/WallE.xpm
EA ./srcs/sprites/test/WallE.xpm

F 50,50,50
C 100,100,100

1111111111111111111111111111111111111111111111111111
1111111111111110000000000000011111111111111111111111
1111111111111111000000000000000011111111111111111111
1111111111111111000000000000000011111111111111111111
1111111111111111000000000000000001111111111111111111
1111111111111111000000000000000001100000001111111111
1111111111111111000000000000000001100000001111111111
1111111111111111100000000000000000000000001111111111
1111111111111111100000000000000000000000001111111111
1111111111111111100000000000000000000000001111111111
1111111111111111110000000000000000000000001111111111
1111111111111111111110000000000000000000001111111111
1111111111111111111110001111000000000000001111111111
1111111111111111111110001111111100000000001111111111
1111111111111111111110001111111100000000001111111111
1111111111111110000000001111111100000000001111111111
1111111111111110000000001111111100000000001111111111
1111111111111110000000001111111111110000001111111111
1111111111111110000011111111111111111111111111111111
1111111111111110000011111111111111111111111111111111
1111111111111110000011111111111111111111111111111111
1111111111111110000000000111111111111111111111111111
1111111111111110000000000001111111111111111111111111
1111111111111110000Z00000001111111111111111111111111
1111111111111110000000000001111111111111111111111111
1111111111111110000N10000001111111111111111111111111
1111111111111111111111111111111111111111111111111111
