NO ./srcs/sprites/test/WallN.xpm
SO ./srcs/sprites/test/WallS.xpm
WE ./srcs/sprites/test/WallE.xpm
EA ./srcs/sprites/test/WallE.xpm

F 100,100,100
C 50,50,50

11111111111111111111111111111111
11111N00000000000G1
11111000000000000B1
1111111111111111111
