NO ./srcs/sprites/test/purplestone.xpm
SO ./srcs/sprites/test/redbrick.xpm
WE ./srcs/sprites/test/mossy.xpm
EA ./srcs/sprites/test/bluestone.xpm

F 100,100,100
C 50,50,50

		1111111111111111111111111
        100000000011000000000P001
		1011000001110000000000001
		100100C000000000000000001
111111111011000001110000000000001
100000000011000001110111111111111
11110111111111000000000010001
111101111111110111010100D0001
1100000011010101110000001P001
10000000000000001100000010C01
10000000000000001101010010001
11000001110101011111011110N0111
11110111 1110101 101111010001
11111111 1111111 11111111111
